	
	                               @@@@@@@@@@@@@@@@@@@                              
			       @@@@@--:...................:-=@@@@
		          @@@@=...................................+@@@@
		      @@@.....-=-.@@@@@@@@@@@@@@@@@@@@@@@@@@@@.==-:.....@@@
		   @@....-======-.@                          @.========:...:@@
                @@...:==========-.@         TALLERS          @.===========-...+@@
              @@....::::::::::::..@                          @.::::::::::::::....@@
	    @@..:.@=%%%%%%%%%%%%#.@.%%%%%%%%%=====%%%%%%%%%%.@.%%%%%%%%%%%%%%+@@...@@
           @..:=-.@               @                          @                 @.=:..@
         @@..===-.@               @         OFICINES         .                 @.==-..@
        @%..====-.@   VESTUARI    .                          =      BANYS      @.====..@
        @.:=====-.@               .        #@@.==:@@-        =                 @.=====..@
       @+.======-.@               @       @         =@       .                 @.======.@
       @.-======-.@               @      @            @      @                 @.======.*@
       @.-======-.@@@@@@:===-%@@@@@@@@@@@    COMAND.  @@@@@@@@@@@@@+====:@@@@@@@.======.+@
       @..======-.@               @      @            @      @                 @.======.@@
        @.-=====-.@               @      @           @@      @                 @.=====-.@
        @..=====-.@    CUINA      .       @@        @        .    DORMITORI    @.====-..@
         @..-===-.@               =          @@@@@@          =                 @.===-.+@
          @:.:==-.@               .                          .                 @.==..*@
           @@..--.@               @         MENJADOR         @                 @.:..@
             @=...@@@@@@@@@@@@@@@@@@@@@@@@@@@      @@@@@@@@@@@@@@@@@@@@@@@@@@@@@..@@
               @@.................@                          @..................@@
                 @@....-=========.@        SORTIDA EXT.      @.==========:....@@
                    @@@....-=====.@                          @.=====-:....@@@
                       @@@@-....:.@@@@@@@@@@@@@@@@@@@@@@@@@@@@.:.....+@@@
                            @@@@:...........PROPULSORS...............@
                                  @@@@@@@@@@@@        @@@@@@@@
